die Unterwäsche : bielizna
das Dessous : bielizna damska
sich umsechen nach : rozgl¹daæ siê
die Müche : fatyga, trud
wetten : za³o¿yæ siê
durchführen : przeprowadziæ
das Angebot : oferta
ähnlich : podobny (do)
umsonst : bez powodu
die Werbung : reklama
beseitigen : usun¹æ (na b)
entfernen : usun¹æ (na e)
glücklicherweise : na szczêœcie
manchmal : czasem
schweigen : milczeæ
sicher : pewny, bezpieczny
gefährlich : groŸny, niebezpieczny
letztens : ostatnio
die Zufriedenheit : zadowolenie
der Berufsleben : ¿ycie zawodowe
die Tätigkeit : czynnoœæ
entsprechen : odpowiadaæ (coœ czemuœ)
eingespielt : zgrany
die Leistung : wynik, osi¹gniecie
glänzen : b³yszczeæ
unbedingt : koniecznie, absolutnie
hassen : nienawidzieæ
unnötig : niepotrzebny
bereit : gotowy
selber : samodzielnie
tun : robiæ
kämpfen : walczyæ
die Gelegenheit : okazja
solange : tak d³ugo, jak
der Verdienst : zarobek, pensja
angenehm : przyjemny
leisten : pozwalaæ na coœ
loben : chwaliæ
der Erfolg : sukces
ständig : nieustannie, ci¹gle
die Anerkennung : uznanie
geschätzt : ceniæ
sofort : natychmiast
davon : o tym
erfahren : dowiedzieæ siê
die Beförderung : awans
hinzukommen : dojœæ (coœ w dodatku do czegoœ)
stark : silny
die Ertwarung : oczekiwanie
der Karriereleiter : drabina kariery
der Vorgesetzte : prze³o¿ony
erfüllen : wype³aniaæ
aufsteigen : wspi¹æ siê
die Aufgabe : zadanie
abhängig : uzale¿niony
der Gedanke : myœl